10111111111
10110000001
10000111101
11111111101
11111000001
11111111111